--------------------
--*---#####*--------
--------------------
---------*----------
--------------------
-#######--------*---
-#-*-##-------#####-
--------------------
--------------------
-----#--------------
--*--#--------------
-----#--------####--
-----#--------####--
-----#-----*--####--
--------------------
--------------------
-------#------------
-------#------------
---*---#------------
-#######------*-----
--------------------